
111111111111
100000000001
101100001111
100100001
100000001
101001001111
1000000000E1
111111111111